111111111111
1PC0C10010E1
100000000011
111111111111