111111111111
1PC0C10001E1
100000010001
111111111111