111111111111
1PC1C00010E1
100011000C01
101000001CC1
111111111111