111111111111
1PC1C00010E1
100011000001
101000001001
111111111111