111111111111111111111111111111111111111111111111111111111111111111111111111111111111111111111111111
1PC1C00010E0000000000000000000000000000000000000000000000000000000000000000000000000000000000000001
100011000C00000000000000000000000000000000000000000000000000000000000000000000000000000000000000001
101000001CC0000000000000000000000000000000000000000000000000000000000000000000000000000000000000001
111111111111111111111111111111111111111111111111111111111111111111111111111111111111111111111111111