1111111111111111111111111111111111
1E1000000000000C00000C0000B0000001
1010010100100000101001000000010101
10000100101010100B1001000000010101
1P0000000C00C00000000000B0000000C1
1111111111111111111111111111111111